wwwwwwwwwwwwwwwwwwwwwwwwwww
ws            s          sw
w                         w
w                         w
w                         w
w                         w
w                         w
w                         w
ws                         w
w                         w
w                         w
w                         w
w                         w
w                         w
w                         w
ws           s           sw
wwwwwwwwwwwwwwwwwwwwwwwwwww
