wwwwwwwwwwwwwwwwwwwwwwwwwww
ws           s           sw
w     bbb   bbb      b    w
w    b   b b   b     b    w
w    b     b         b    w
w    b  bb b  bb     b    w
w    b   b b   b b   b    w
w     bbb   bbb   bbb     w
ws                       sw
w   bbb   bbb   b   bbb   w
w  b   b b   b  b  b   b  w
w     b  b   b  b   bbb  w
w   bb   b   b  b  b   b  w
w  b     b   b  b  b   b  w
w  bbbbb  bbb   b   bbb   w
ws           s           sw
wwwwwwwwwwwwwwwwwwwwwwwwwww
