wwwwwwwwwwwwwwwwwwwwwwwwwww
ws           s           sw
w                         w
w     bbbb        bbbb    w
w    bwwwwb      bwwwwb   w
w                         w
w b  b  bbb  b   b    bb  w
w b  b  b    b   b   b  b w
wsbbbb  bbb  b   b   b  bsw
w b  b  b    b   b   b  b w
w b  b  bbb  bbb bbb  bb  w
w                         w
w     bwwwwb     bwwwwb   w
w      bbbb       bbbb    w
w                         w
ws            s          sw
wwwwwwwwwwwwwwwwwwwwwwwwwww
