wwwwwwwwwwwwwwwwwwwwwwwwwww
ws           s           sw
w                         w
w                         w
w                         w
w   bbb   bbb   b   bbb   w
w  b   b b   b  b  b   b  w
w     b  b   b  b  b   b  w
ws   b   b   b  b   bbb  sw
w   b    b   b  b  b   b  w
w  b     b   b  b  b   b  w
w  bbbbb  bbb   b   bbb   w
w                         w
w                         w
w                         w
ws            s          sw
wwwwwwwwwwwwwwwwwwwwwwwwwww
